***********
*        G*
*         *
*         *
*         *
*         *
*         *
*S        *
*         *
*         *
***********
